XXXXXXXXXXXXXXXXXXXXX
X...X.X.............X
XXX.X.X.X.X.XXX.XXXXX
X.X...X.X.X.X...X.X.X
X.XXX.XXX.XXXXX.X.X.X
X.X.......X.X.....X.X
X.XXXXXXX.X.XXXXXXX.X
X.X.X...X...X.......X
X.X.X.X.X.XXXXX.XXX.X
X.....X.........X...X
XXXXXXXXXXX.XXXXX.XXX
X.....X...X.X.X...X.X
X.X.X.XXX.X.X.XXX.X.X
X.X.X...........X...X
XXXXXXX.XXXXX.XXX.XXX
X.......X.....X.X.X.X
X.XXX.X.XXXXX.X.XXX.X
X.X...X.X...X.......X
XXX.XXX.X.X.X.XXX.X.X
X.....X...X.X...X.X.X
XXXXXXXXXXXXXXXXXXXXX
